__======================__
|==....................==|
|........................|
|........................|
|........................|
|........................|
|........................|
|........................|
|........................|
|........................|
|........................|
|........................|
|........................|
|........................|
|........................|
|........................|
|........................|
|........................|
|........................|
|........................|
|==....................==|
__======================__